codon	aa
GCC	A
GCG	A
GCU	A
GCA	A
AGA	R
CGG	R
AGG	R
CGA	R
CGC	R
CGU	R
AAC	N
AAU	N
GAC	D
GAU	D
UGC	C
UGU	C
CAA	Q
CAG	Q
GAG	E
GAA	E
GGC	G
GGU	G
GGA	G
GGG	G
CAC	H
CAU	H
AUA	I
AUC	I
AUU	I
CUG	L
CUA	L
UUA	L
CUU	L
UUG	L
CUC	L
AAA	K
AAG	K
AUG	M
UUC	F
UUU	F
CCG	P
CCC	P
CCU	P
CCA	P
AGC	S
UCG	S
UCU	S
UCA	S
UCC	S
AGU	S
UAG	*
UAA	*
UGA	*
ACA	T
ACC	T
ACG	T
ACU	T
UGG	W
UAU	Y
UAC	Y
GUA	V
GUG	V
GUU	V
GUC	V
